$leveldim 24 20

$player 170 350 0.1 7 0 0 0 0
$dude 280 90 1 7 0 1 1 2
$dude 80 110 0.1 7 0 1 2 1
$dude 200 350 0.1 7 0 1 3 0

$collisiondata
0 0 0 0 0 0 0 0 0 0 0 0 0 0 0 0 0 0 0 0 0 0 0 0
0 1 1 1 1 1 1 0 0 0 1 1 1 1 1 1 0 1 1 1 1 1 0 0
0 1 1 1 1 0 0 0 0 0 0 0 1 1 1 1 0 1 1 1 1 0 0 0
0 1 1 1 1 1 1 1 0 1 1 1 1 1 1 1 0 1 1 1 1 0 0 0
0 1 1 1 1 1 1 1 0 1 1 1 1 1 1 1 0 1 1 1 1 0 0 0
0 1 1 1 1 1 1 1 0 1 1 1 1 1 1 1 0 1 1 1 1 0 0 0
0 0 0 0 0 0 0 1 0 1 0 0 0 0 0 0 0 1 1 1 1 0 0 0
0 1 1 1 1 1 1 1 1 1 1 1 1 1 1 1 1 1 1 1 0 0 0 0
0 1 1 1 1 1 1 1 1 1 1 1 1 1 1 1 1 1 1 1 0 0 0 0
0 1 1 1 1 1 1 1 1 1 1 1 1 1 1 1 1 1 1 1 0 0 0 0
0 1 1 1 1 1 1 1 1 1 1 1 1 1 1 1 1 1 1 0 0 0 0 0
0 1 1 1 1 1 1 1 1 1 1 1 1 1 1 1 1 1 0 0 0 0 0 0
0 1 1 1 1 1 1 1 1 1 1 1 1 1 1 1 1 1 0 0 0 0 0 0
0 1 1 1 1 1 1 1 1 1 1 1 1 1 1 1 1 1 0 0 0 0 0 0
0 1 1 1 1 1 1 1 1 1 1 1 1 1 1 1 1 0 0 0 0 0 0 0
0 1 1 1 1 1 1 1 1 1 1 1 1 1 1 1 1 0 0 0 0 0 0 0
0 1 1 1 1 1 1 1 1 1 1 1 1 1 1 1 0 0 0 0 0 0 0 0
0 1 1 1 1 1 1 1 1 1 1 1 1 1 1 1 0 0 0 0 0 0 0 0
0 1 1 1 1 1 1 1 1 1 1 1 1 1 1 0 0 0 0 0 0 0 0 0
0 0 0 0 0 0 0 0 0 0 0 0 0 0 0 0 0 0 0 0 0 0 0 0

$tiledata
11 7 7 7 7 14 7 7 14 7 7 14 7 7 7 7 12 6 6 6 6 6 3 3
8 5 5 5 5 4 4 30 8 31 4 4 5 5 5 5 8 1 1 1 1 1 3 3
8 5 5 5 5 9 7 7 13 7 7 10 5 5 5 5 8 1 1 1 1 3 3 3
8 5 5 5 5 5 5 5 8 5 5 5 5 5 5 5 8 1 1 1 1 3 3 3
8 5 5 5 5 5 5 5 8 5 5 5 5 5 5 5 8 1 1 1 1 3 3 3
8 5 5 5 5 5 5 5 8 5 5 5 5 5 5 5 8 1 1 1 1 3 3 3
9 7 7 7 7 7 7 5 17 5 7 7 7 7 7 7 10 1 1 1 1 3 3 3
6 0 0 0 0 0 0 19 0 19 0 0 0 0 0 0 0 1 1 1 3 3 3 3
6 0 0 0 0 0 0 19 0 19 0 0 0 0 0 0 0 1 1 1 3 3 3 3
6 0 0 0 0 22 18 28 18 26 0 0 0 0 0 0 0 1 1 1 3 3 3 3
6 0 0 0 0 19 0 0 0 19 0 0 0 0 0 0 0 1 1 3 3 3 3 3
6 0 0 0 0 19 0 0 0 19 0 0 0 0 0 0 1 1 3 3 3 3 3 3
6 0 0 0 0 19 0 0 0 19 0 0 0 0 0 0 1 1 3 3 3 3 3 3
18 18 18 18 18 24 18 18 18 24 18 18 18 18 18 18 1 1 3 3 3 3 3 3
6 0 0 0 0 19 0 0 0 19 0 0 0 0 0 1 1 3 3 3 3 3 3 3
6 0 0 0 0 19 0 0 0 19 0 0 0 0 0 1 1 3 3 3 3 3 3 3
6 0 0 0 0 20 18 18 18 28 18 18 23 0 1 1 3 3 3 3 3 3 3 3
6 0 0 0 0 0 0 0 0 0 0 0 19 0 1 1 3 3 3 3 3 3 3 3
6 0 0 0 0 0 0 0 0 0 0 0 19 1 1 3 3 3 3 3 3 3 3 3
6 6 6 6 6 6 6 6 6 6 6 6 19 6 6 3 3 3 3 3 3 3 3 3